1111111111111111111111111111111111
1E0000000000000001110X000X00000001
1E00010000100001110111000000000001
10100100001000010000110000X0010101
10100100001000X0000110000000010101
1000011111100000001100000000000001
1010000000100000110001000000010101
1010000000101011111111000000010101
1P0000000C10000000000X000000000001
1111111111111111111111111111111111
