111111111111
101111P00001
11111C0000E1
111111111111
