11111
101E1
111P1
1C001
11111
