1111111111111111111111111111111111111111111111
100C000P0000C000000000000000000000000000000001
1C0C0C1111100000000000000010000000000000001111
100000000E1100000X0000000000000000000X00000001
111000000110C0000X0000000000000000000000000111
1C0C0C1111100000001000100100100100100100100101
100000X000110000000000100000000010000000001001
111000000110C0001000001111000000110C0000000001
111000000110C0000X0000000000100000000X00000111
1C0C0C111110X000001000100100100100100100100101
1000000000110000001000100001000100000000010011
111000000110C0100000001111000000110C0000000001
1C0C0C1111100000000000100100100100100100100101
10000X0000110X00001000100000000010000000001001
111000000110C0000001101111000000110C0000000001
1111101111110111111111111111101111111111111111
111000000110C0001000001111000000110C0000000001
111000000110CX00000000000000100000000000000111
1C0C0C1111100000001000100100100100100100100101
10000X0000000000000100100001000100X00000010011
111000000110C0100000000111000000110C0X00000001
1C0C0C11111000X0000000100100100100100100100101
1000000000110000001000100000000010000000001001
111000000110C0000001101111000000110C0000000001
1111111111111111111111111111111111111111111111
