1111111111111111111111111111111111111111111111
100001010111100000000C0000001111C0000111111111
1111111111111111111111000000000000000000000111
100X00C101011001000000000000CC11C0000111111111
1000000C000000010000010000000C00C0000111111111
10101001100000010110010000001111C0000111111111
1E000101111110011110000000001111C0000111111111
10010001111110000000000000001111C0000111111111
1P100011111110000000010000001111C000E111111111
1111111111111111111111111111111111111111111111
